. . . . . . . . . .
. * . . . . # # . .
. . # . . . . # . .
. . . . * . . . . .
. . . . . . . . . .
. . . . . # # # . .
. . * . . . . . . .
. . . . . # # # . .
# # . . . * . . . .
* . . . . . * . . .